documentAll 	    	false
useNormalComments   	false
HTMLSyntax  	    	true
fileList    	    	doc++/documented_files.txt
parseJava   	    	false
ignoreDefines	    	false
documentPrivateMembers	true
optimizeForSpeed    	false
quantelExtensions  	false
internalDoc 	    	false
doTeX	    	    	false
upwardsArrows	    	true
verboseOperation    	true
scanIncludes	    	false
parseIDL    	    	false
useTables   	    	true
useTablesWithBorders	false
footer	    	    	doc++/footer.html
outputDir   	    	html
showFilenames	    	false
showFilenamesWithPath	false
noGifs	    	    	false
forceGifs   	    	false
noInheritedMembers  	false
noJavaGraphs	    	false
trivialGraphs	    	false
noMembers   	    	true
showMembersInTOC    	false
discardGeneral	    	false
sortEntries 	    	false
header	    	    	doc++/header.html 
groupBeforeGroup    	false
classBeforeGroup    	false
htmlSuffix  	    	.html
